####################################################################################################
#     ##        #  # ###  # ##       #    # #    #  ## #    ## #  #     # #    #  #        ### #  ##
####           #  #    #  #   #   # #   ##  # #       #  #  ## ### #     #  #### #   ### #    #   ##
##        #     # #  # #  #    ##   # ## ###  #  # ## # #### # #  #   ## ## # ##      ##     # #####
###    ###  ##    #   #       ###   ## ##       ##### #  # ####  # # # ###  #      #    # #  #  ## #
##  ##   #    ###  ##            #   # ###  #   ### #   # ##### ##  #    #  ##  #  ##  ##   # ##   #
##      #    # # # #        ### ###    ### #     #  # # # # ##     ###     # #    ##   ##   ##     #
# ####  #   #   #     #       # #     #      #   #   #   ##    #  # # ### # #     # ## # # # #    ##
# #        #####  ##  # # #      # #   #  #  ##   # #   #    #       ##   #  #  #      #  #  #######
## #    ##    ## #  #   #         #   # ###   ##    ##  # ## ##      # # ##  # #   ## #       #    #
#  ######     # #### #   # # #     #    #     #  ## ##   ##    ###  ##       #      # # ##   # #   #
###   #   #   #  #   ## #  #  #   #    #   ## ##  ##   #  #       #   #    #     # # #  #     #    #
##   ## # #  #  #         #   # #  #    ##    #  #  #  #                          # ####     #    ##
#   #   #   #    ##  # # #       #   # #  # #    # ###  # ## # #    # # #    # ###        #        #
# # #  # ###    ## # #  ##       #             ### #   #  # #         #   #    #  ##    # #   #   ##
##  # # ### #  #    #    #     #      #    # ##  #   #    #    # ## ####      ##  ###  #    # # #  #
#   ##   ## #    #     #      #   # #  #   ###    #  #   #   #       # ##   ### #    ###  # # #   ##
# #  # ##    ##     ##     # #         #      #    ##    ## # # ###   #      ##     #   # #####   ##
##  ##    # # ## ## ##   ## ###     # # # #   ##  # #     # ####  ##   # ##             #   #  #   #
###     #     ##  #      ###   #    # # # # # # #  #      ##    #        ##  #    ##  ##    #      #
## ##### # # # #   ## # ### ##  # #  #       #      #### ####  #  ##  # ## #    #   #  ###     #   #
#   # #   #       #      ## # ###          # #   #   #   # #      #   #     #    #    ##   ## #   ##
#   #    ##           # #    # ##  #      ##  # #   # #     ## # ##  #   # # #  # #   ###    #     #
## #  #   ###    #  # #    #  # # ##        ##       # #   #   #  # # #   # # # #    #### #      # #
#     #         # ##  #   #   # #   #   ##    #   ##        #  ### #  ### ##  ##      # # ###    # #
#   ###  ##    #   ##  ## # # #### # ###      # #     ##  # ## ##  #     #   ##   ###    # #    ## #
# #   #     #      #  ### # #  ##      ### # ##  #     # #        #     #           #### #   # #   #
# ## ##    ## # #          #    ## ##                     ## #    # ###  ## # ##  #  #    ## #     #
#        #   #    #     ### # #        #       # #   ##  #      # ##      # ###       ####    #### #
##   # #  #  #   # #  # # # #     #   #      #      ##    # #      ###     #  # #   #   #        ###
#       # ## # # #  #  ###  #      #       ##   #  #  # # #   # ## #  # #   ##   #     #      # #  #
###  # #  #  #  #      # ##  #  #  ###  ## # #  #       # # # #  #    ###    ## #  # #    # #   #  #
#      #   #   #    # # #### ##      #       # #  #    #   ## ##  #  #  ##    # #          #    # ##
# #            # #  # ##  ##  #         #     #     ### #  ## #           ## ###   ## ##  #####   ##
##   #    # #     #   ## #  ##    #    #    # # # ## # #  ###   # # ###  #  ##  #    ## # ## #     #
# #        ######       # ##     ## #  # #  #  # ## #  #       ## # # ###     # # # # ###          #
# ## #    ###   # #   ##  # #          ##### # ###      # # #     #    # ## ##    #   #     ###   ##
#     #   ##     ####     #####     ## #   # #  #         #  #        #  # # #   #   #   # #### ## #
## ####   ##     # # #      #   # #       #  #  #    # # # #       #  #   # ##   ## #  #  ##  # # ##
#    # ###  #      # ## #  #  #  ## ##      #      ##  #  #  ###   #    # #      #   # # #  #  #   #
# A ##  ###  ##  #  # #    #  ##      #   #      #   #  # #   #   # # # #   ##    #     #  #    #  #
###          #  #   #   ###       #    ##  # #  ##  ####     # ###   ## ####  ### ####  #  #  # #  #
#       #  ##      ##     #   #  #   #  #      #    #    # ## #  #  #      # #    ##     ## ### #  #
# ###    ##  # ##  #          ##   #    # #   ## #      ##  #     #      # #   ###  ###    # ## #  #
##  ## #  #     #   #   #### #####  # ##  #  ## ##  ## #       # ## #  #    #    # ##  #  #    ### #
#  #  ##       #        #  #  ####   ##        #    #     # #  #  ## ##   #   # ##     #       #   #
#       #####     #       #    #  #  #               ### # #   #  ##   #    # #    #        # ##   #
## #        # #     # # #    #   #      ##  #           ## #     #   #  #   ## ## ###   #       #  #
#  # ##     #   ## ###   #     ## #  ##        #    #    # ## # ##      ###  # #  #  #     #  #    #
# #  # ##      #       ### #####   ## #        # ## ##   #   # #   #  # #  #  # #     ##  ##      ##
#   #  ### #      # # ###  ##  # #    #  #  # # ##   #    # #  ####    ####    # #   #    # # #    #
###    #         #   # # #  #  #  #  ## ## # #  ##     ##                # #        ### # # #   # ##
## ##  # #    #  #     #  #  # # ## ### ## #   #    ## #  #  #               ##  ### ##     #  # # #
#      # #      #  #           # # #   ### ###       ##   ##  ##       #    # ###    # #   #   #  ##
#   ##   #   ##  ##  #  #####     #     # #  #           #      #  ##    ##      ###  #  ###    # ##
##     #  ## #  ### # #            #        ## #       # # ###    #          #     ##   ##     #   #
# ## ##          #     ## #    #   #      #   ## #         ###### ## # ## ## #### # #    # # ###   #
#  ##   ##   ##     # ####    # ##   #       # # # # #  ## ## #  ## #  #  #    #   #     ##        #
#  #  #         # ##              ##  #    ## # # #   ##     #  #      #   #    # #   ###    ##    #
##     # # #            # #  ###  # #    #   ## #   ## #      ###     #       #          ### # #   #
##          #   #      #    ##  #    ##  # ## #    #     #   # # #  #  ####   # #  #        #  #   #
##    ### #   ###   ## # ##     ###  #    # ##   ###      #     ##  #   ##   # #  #    #  #     #  #
##  ## #      #    # # ####     #     ###     #  ##  # # ##  ##  ### #  #  #  # #   #  # #    #    #
##  #  # ## #          # ##   #  # # #        # ##  ###### #####      #  ### #  #   #    # #      ##
#####     # ## #### #   # ## #     ##      ###   # ### #       #  #  ## ## ##         #    #       #
# # #  ## ##      ## #         ###     ### #   ##   #  #     ####  ##    #  #     # ## # # ###  #  #
#  ##           #    ###   #  #  ## #  # # #    #  ###  #   #  #  #   # ##       #   # # #  # #    #
### ####  #   ###     ###  #####               #       #    # ##   ####         ###  ###  #  ##  # #
##     #    ## #   #    ###      ## ##        #    #     #   # ## #  ## ##  # # ## # ## ###  ##    #
#       #  #    ##   #    ### #  #      # # ##  # #   #  #####  ##   #    ##  #           # # #    #
# #    #  #   ##  ##     ## #   #  ## ##  #   # #  #       #  ##         #  ##  # #  # #  # #  #   #
##     ##        #   #    #    ###  #       #        #  #  # #  ### #  ## #   ##   #   # # # ## # ##
#         #       #     ####    #   # #   ##         #     #       #       ##  #      #  # #    ## #
## ##   #     #   ###  #  ## # ## #  ##  ##   ##      ## #   ## # #   #  ##    # ### ##        # # #
# # ##  ## ##   ## #     # #   ### ## #    #         # #     #   #  # #    ## ####      ##  #  ##  #
##  #    #     # ##        #    ##  ###        #    #      #  #  ###      ##  ## ## # #     #  #  ##
# #      #  # ##       #          #     # # #   ##              # #        # ###    #  #   #  # # ##
#    ##     # # #   # #    #  #    ##  #      # ##  ##    #   # ## #  ###   #  # #  #        #     #
## ##    #   # # ##      ## #     # ## ###       #        ##   ## # # ##       #  ###  #   # #     #
#   ### ###        #####     ##     #    #  #     #   #     ###  ## #  #  #       ##   # ## ##     #
# #   #   ## ##    ##### #  #     #    #      # # #  #  #   # # #   #  ## # ### ###     #    #     #
###    ## #     #     # ##  #    ##      #   #  #     ##### #  ###         #  ####   # ## #     # ##
##  #  #         #   ### #   #   # ##    ###         # #    #########  #  #     #     ###  #    #  #
#    #    # ##       #   #    ###     ##   # ###   #  #  #     #        ## ## #    # #    #  # ## ##
#     # ## #   #   ##  ##   ## ###  #        # ## ## #  #  ##   # ##   ###    ##   ### ##  ## #  ###
# ## ##  # # #  ###  # #   #  #     #   ######   ##  #   #   # # ##   #   #  #  ## #    #     # #  #
##  ###     # # #  # #   # # # #       #     ##      #      # # ##   ## # # #    #  ##  # ##      ##
##    #       # # ##  #   ##     # ##   # #   #   ## # # ###  #    # ### ###  #  #   # #     #  #  #
#     #  #             # #   #  #    ##  # #   #   #       ###     #       #    #           # # # ##
##        #  # #         # ###  ###   B   # #       #     ##  ###  ## # #   #  # #  ###  #      #  #
## #####     ##      ## #  ###    ##   ####         #  ####   #         ##   ###   #    ####  #    #
#  ##  #    #  #     #   ##    ## ##  #   #  ### ##   ###      # ## ##    ## # #        # #  #  ## #
#  ###  #  ###          ####  ####   #  #          #    #   #    #  #  #   #  ##  ##   ## ##   #   #
#      # # #         # #   #   ## ## # #    ##    #  #  ###   #   # #    ## ## # #  #   #   ## #   #
#  ## #  ##     ##   # # #    # ### ## ##        ##   # #  #    #   # #       ###   #  ##    #   # #
#  ##               #  #   #  ## ### # # #       # #    #       # #     #   ##     #   #  # # #   ##
#  #  ###  #  #      # #  # #        #  #  #  # #          #  #  ##   # #             #  # #  #   ##
# # ## #     #     #      #               #####     #  ##  ##  #        ##  #       #  #######  ## #
# #  #               ## #         ###       #### ##    # ## #   #   #  #    # #    #  #   #  #  ## #
####################################################################################################
