####################################################################################################
### ##  #### # # #   ##      #  # #   # #  # #  ## #  ## ##### ##  # #  ### #  # ##     # # ##  ## #
## #  ##  #    #    #  ## # ###  # # ######    # # # ##  ## #   # #  #  # #  #  ####   #  ##   #  ##
#  #    ######     # # #### ## ## # # ####   ## ## ##  ######## #    #  # ## ###   ######      #  ##
##     #   ###### ## ###### #    ##  #### #    ###     # ### #  #  # ### ## #    ## ##    #   #  # #
# ###### # #     ##  #   #   #  ##  # #    # #    # #   #       ### #  ##   #   #### #### ## #### ##
# ###    #  #      #      #### ###  # # # ##   # #  ### ##  # ## # #      # # ###### #    #####    #
##### #    # # # ## #  ## ###  ####  ## ###   # #   ##### #  ##   # ##       # ##  ## # ###  ####  #
# #      ## #  ## ### #   #   # ###  # #### #  #      #  ###  # ## ##    # #   ####  #     ###    ##
## # ##     #   #    # # # ## ## ###  ######  #  ####      ##   #    # # ### # # # ##### ## ###    #
# # #   #    #   ####   #  #### ##  ##   #####      ## #    #### ## ##    #### ##   #   #  # #  # ##
# # #  #  # ### #   #     ## # #       ###   ##  #  # ## # # # ###  # # #  # ## # ####  #  ##  # ###
##  #      #   ### #   ##  # ## #  ### # ## #     #     ### ##     ####  #          # # # #######  #
## # # ########    ### ### # ####  #  #### ##  ####  ## # ###### ###  ## #####  ##  ###   #    #  ##
##  #  ### #  #  ##  ##  ##   ##  # #     #####  ##  # # ### #     ###  ### #### #####  ## #    ####
# # ##  ###  #  ##    #  ### #######     ####  #   # # # #   # ### #  ##  # #   #   ######       # #
###    # #  #### ##      ##   #  #  ##   # ###  #####  ### ## ##  ## # # ## ##  #  # # #  #   ### ##
### #  # # #   #   #  #   #######  ##### ## ## # ### ##### ##  ####  ####### ##   #  #####   # #  ##
## ### #     #      #   #  #    #   # #   #####  # ####   ##  ## ##    #### ### ####### #       ####
#  #  #  ##  ###  # #  ## # #  ## #  # #  ##  #    # # ###   ##   ##    ## #  #     ###  ## #  ##  #
##   ### ## #  ### #  ##  ###### #    #  ####    ### # ## # # # # ## ##  #   ##  ## #  # # ######  #
#### #####   # #     ###   # ##  ## # # #### ## ##  ##  #     #  ##  ## ### ######  #   # ### #   ##
## #  ##  # #    #####   #  ####  ## ## # ## #     #     ## ## # #   ## ###  ## # ### #   #### # # #
#### #### ##     # ####    # ## ## # #   ##  #####  # #  #### ## # ##  ### #   ##  ##  # #        ##
#   #####  ### # #  # ##  ##  ### ####  #   ###    ###### ## ## ###   ##    # ### # ####  ## # # ###
## ##  #####  # ##  #   # ##  # # ###  # ######  ## # #   ###     # ###  ##   ## ## #   #  ##  ##  #
###   #  #  # #####  #     ### # ## #  ##  #   #  ## ###  ####  #  ###   ##  ## #### ### ### #     #
#   # # ##   #  ## ##  ## ###  # #######       ####### ###### #        # # # ######  ##   ##  ###  #
## ##  #####  # #  # # #  ## # #    #   ######  ##   # ## # ####  #  ###  #   ## ###     ##  # #####
# #  #  # ##  # ##    ### ##  ##  #  ### #####    # # #            # #  #  #  # #      # ### #  # ##
##  ##### # ## ##   ##  #   ## # ###   ###### #   ## # ### #  #  #   ##   # # ## #  ## #  ### #### #
##   #### ##  # ###  # #### # #  #  # ##  ##     A ###   ##   ##    # ####    B  ##    #  # #   # ##
###  ####        #### ### ## #   ###    # # #  # #  # ## #   #       ## ## #   # ######  ##  #######
#   #  #  # ###   ## #   ### # # # ###      # #   # #  ###  ##  #  ######  ## ###  ##      #       #
#    # # ## ## # ## #  #   # #  # # ## ##  ## # # # #    ### #  ###      ##       ####  # ##    ## #
### ##### # ###     ##  # ###  ##  #    ## #### #      ######  ##   ##  # #  #  ### ## # ###  # ####
###### ####   #  # #  # #  ####   ####  # #  ## ##  # #####    # # # # ## ###  #####  # ## ##  ## ##
##  #   ###  #   ## #         # #  # ###     ####  #   ##    ###         #### ## ### ### #### ###  #
# ###  ## #  ###  ##  # #  ### # # #### #  ###  ##### # # # #  ####   ##  ## #  ### ## #   #     # #
##   #  #    #     ### #    ###   ### ##### #  ##   #        ###   ##    ## # # # #### ##  ##     ##
# #  ###  #  ### ###### # ## ## #  ###   ## ##  #  # ### ####      # ##        #####    #     #  # #
### #     ## #      ## #### # # ##    ###    # # #  #### ## #     ## #  #  ### #  ## ###        #  #
###### # #   ## ###   # ####  # ### ###  ##  ######## ## ## #  # #   ##  # # # ##  # #  #   ###  ###
# ##      #  ###   ####    ##   #   # #  #    ###   #  ##  ## ### # # #   # #    ## #   ### # ## # #
#  ### #    ###     ### ## #     #    ##  #   # ###  ## ## ##### ##### # ##  #### # # #      ###   #
##  ####   ####  #   ##    # # # # # ## ## ##    # ##     ###  #   ####### ## # ###  # # ### # ##  #
### #  # #### # # ### ##  # #  # # # #    # # ### # ####### #  #   ###  # ####    # ###  ##     #  #
#  ##### ##  ## # # ## # ##  ###        #   #  #### ## #####  #     #  ## # ## # # # ##### # #######
# ## ###    # #####            ##  ## # ####### #   ####     # ##  #       ##  ######   # #### ### #
#   ###   ## ### #  ## # #  # #  #  # ##   ## #  ###  # #      # ##     ##   # #  #      # ### ### #
#  ####### # # # ## ## ## ####   ### # #  # ###    ## ######### ##  # #   ### ########   #  #  #####
### #  #  # #   # # # # ##  ##  #  # #      # # #  #### #  #####  # #####  ###   #  # ## ##   # # ##
# # ##   # #  ##   #  ##      # ## ## ###   # ## ### # ##  ##    ####   ###    # #  # ######## # # #
# #   #   # ##     ##    ##### ### ##  ##      # # ### # #  ## # #  ##    #     ##### ## #   # #####
## # #### #    ##  ####        ## ######   ####  ### #####   #  # #   #  ###     ### ### #  #  #####
## #  ###### #  ### #    ##     #  #####  # ## ##  ##  ## #   ##### # ### #  ## # #        #  # ## #
##  #  #  ##  ## # #    #     #  #   # ##   ###   #   ## #   ###     #  #######  #####  ##    ## ###
### #       ## # ##  ##   #### #   #          ## #### # ## #   # # # ## ## # ##      ### ## ##  #  #
#   # # ## #   # # #### #  # # #####    ##  ### # #      ##### ### #  ##   #### #####  # ##  #  #  #
#  # # ##### ### # #        # # #   # ###  ##               # ##  # #### #  ## # ##    #   # # #   #
#  ###   # #  ### # ###  ## #  ###   #   ##### ## # # #  ### #  #   # ## #   # #  ### #  #    ###  #
###  ## # ######## ##   ##  #   # # ## ######   #   ## ##   ### #  # ##   ###  # ##   # ####  ### ##
####  ##  ## #  ####        ##   #   # ###  ##  #  ##    #  ##  # #  ### #      #   ## #  ######  ##
##   #  #   ##   ###    # # # # ###  # # #####    # ##    #### #### ##     # # ######## ###    ## ##
#    ### ###   ## ###  # ####   ##  ####  #  # #   # # #  ## ##     #####  #    # # ##      #     ##
#  ## ## #   ###  #    # #    ###   #  ## #   #     # # ####  ### ## # # # # ### ##### #   # #   # #
# #### ## #  #####  ##  ##  #    ##  ######   # #   #     ######   ### #  # ##    # #  ### ### #  ##
# ###    #  #  ## ##  ### #  ##  #     #    ## # ##  #      ##  #  ##  ## #  # #  # ### ### #### ###
# ## ##   ########   #    ##  #  # ## #   #   #### #   ## # #####     ## ####  #     # # ##  # ##  #
##   #    # # # ##     ##### ###### #  # ## # #### ## # ##   ###   ## # ####  #   # # ##     # ##  #
# # #  ####   # # #### ##  ## ##  ## # # #  # ##   ###### ####  #  ###  ####     ####   # #######  #
# ###  #         ### #   #  # ## ##  ##   #   #  ######  ## #### ## #   # # #######      ### #  ## #
# # #       # ##   # #   # #####    # # ###    # #   ## ##   #    #   ##    #   #  ## # ##   ## #  #
## #### #  # #    #      ## ##   # ###   ##  ##    # #   ##  ### ## ##    #   # # ##   # # ### # ###
##     # # ## #  ###### #  ## ## ## #  # ### ## ##### ###  ## # #   # #####     #  # #  # ##  ##   #
#    ## #  ##     ##  # # ## ## # # # ##  # # # ## ###### # # #  # ##   ##   #  # # #    ######   ##
####  #  # #   ##   #  # #        # ### # # # ##  ### #####      ## #   ## #####    ##    # # #    #
## ###   # ##  # # # # # #  ##  # #   #  #  ##### #  ### #   # #  ###  # # #         #  ## #  #  ###
# #### #   # #     ##     # ####   ## ##  ## ### #   #  # #     ## ###    # # ## #  ##  #####  # ###
# # ##  #  ##   # ###    ### # # ## ##   ###  #       ####       ## ##   ## #     ###   ## ##  #  ##
#### #### # # ##  ## ## # ## #### ### ### ## # # # # #     #   #     ## # # ## ##  ##    ##   ##  ##
## ##    ####   ## ##  ## ##  # #   #   ##   #### #  ##### ###   # #   ##  #  #      ## #   ##    ##
# # #    # ## # # # ## # #      ##  # # #  #    #########   ## ##   ### ####### # ### ###  #### # ##
# ##   # ######   # ### # ### ##  #  #   ###  #   #### ##  ##    ##   #  #####  #  ### ## ###   # ##
##  #  ##  # ##  ## # # ###  ##      ## ##  ##   #   #    #  ###  #  # #### # ###   ##   #### ######
#   ###   ##### ### # #  ##  #   #   # # # ## # ###    #   #  ###### #   #    #### #### #     ##  ##
##  #  #  ####  ##      ## # # #  ##### #    # ## #  #  ### ##  # ##   # #    ##   ### # #  ##   # #
##### #####   ### #   #  # ### # # # # # ######  ##     # ####  ###  # #  #  # #   # #    ##  ### ##
## # ## ##  ##   # ###### #  # #    ###### ####         ###   ## # #      # # # #     # #    # ### #
#  #  ### ### ##    #  ## ##  #     #  # ###  ## # ## ## ####  #  # #   #  ##     #### #       #   #
## #  ### ####### #####   #  ##  ### # ## #   ###  ##       # ##### ##  # # ## ##  # #  # # ###   ##
###    ##  # ##### # ####     # ## #   # # #  # ##### ###  #    ####    #### ### ##   ###    #     #
#   ###  #    ## ## ## #  ##  ##   # ########   ##        # #    ## ##  #     ##  #     ##### # #  #
##  #####  # ##  ## ### # #  # # #    #######   #   # ## ## #         # #  ###  #  #  #  ## #   ####
##  #   # ## ##    #  ###   #  #    ##  #  ##### ## #  ###  ### ### #### ### # ### ### ##  # #  #  #
#  ##    # #         ## # ### # #  ####       ##  # #####  ##      #  #######  ##### ##   ## ### ###
####  #  ### #### ### # #  #         # #  #  #  #  #### # # # #        #  ## # # #  ##     ##      #
#   ## # # # # ##   ### ##  # ####  ##  ## ## ##  ### ### ####   ###  #  ## ####  # ## ##  #       #
####   #  ###   #   ### ## #  #  ### #  ##   ## ## ### ## #   ## ######### # #######   # ## # ######
####################################################################################################
