##################################################
#              #           #                     B
#  #####       #  #####    #  #######   #########
#  #           #           #           #        #
#  #  #########  #########  #########  ###### #
#  #           #        #    #                 #
#  #########  #########  ###  ############## ##
#           #           #      #              ##
#########  #########  #########  #########  ##
#           #           #           #        ##
#  #######  #########  #####  #####  ###### ##
#              #        #           #           #
#############  #  ######  #########  #########
#              #              #        #        #
#  #########  #######   #########  #####  #####
#        A           #           #              #
######  #########  #######  #####  ############
#           #           #        #              #
#########  #######  #####  #########  #########
#           #        #              #           #
#  #####  #####  #####  #########  #######  ###
#        #        #              #           ###
#####  #########  #############  #########  ##
#     #              #           #           ##
#####  #########  #####  #####  #############
#                 #              #        #   #
######  ############  #########  #####  # # #
#           #           #           #     #   #
#########  #########  #########  #####  #####
#           #        #           #              #
#  #######  #####  #####  #############  #####
#  #              #        #              #    #
#  #########  #########  #########  #####  ##
#        #           #           #           ##
######  ############  #######  ##############
#           #           #        #           ##
#########  #######  #####  #####  ######### ##
#           #              #        #        ##
#  #####  #############  #######  ######### ##
#        #              #              #     #
##############  #########  #####  ############
#              #           #        #        ##
#  #########  ############  #####  ##########
#  #           #           #           #     ##
#  ############  #######  ##############  # ##
#           #        #              #        ##
############  #####  #############  #########
#              #              #              #
##################################################