####################################################################################################
#  ##    ##    # #   #  #  # ##                    #   #     # #  #    # #         #    # #    # ###
## #   #  ###    ### #    ##     ##          #  # #   ### #  # ##            # #     #     #       #
#      # ## #               # # ##   #    ##           #    #   #          #   ###  # ##       #   #
# ##    #     #       #  ##   ###  #  #  #    #      #  #     ##  #              ##   #        #   #
# # #    #   #    #     #      #      ##       #          # ##       #  #   # #   #         #    # #
#  #    #               #   #     #   #   ##     #     #       # #       #  # #   #           #    #
#      ##    #             # #   ##              #     ##  #           #             ##    ##    # #
#            # ### ###  ##    #        ## # #   # #       #     # #  # ##      #      #    #       #
#    #  #   #       #    #       #        #  #   #         # #  #     # #    # #        ##       ###
### #  ## #  #   ###  # # #   #    # # # #                ##      #   #        #   #  # ##  #   ## #
#              # #     ##  #   #     # ####   # #  ###    #    # #  #        # ## #      ##     #  #
#  ###   #   ##   #        #          #               #         # ##     #   #     #  # # #        #
#         #     # #    #              # # #   # #  # ##              #  ###             ##         #
#    # #   #      # ## #  #   ###   #       # ### # ##    #     # ##           #           # #  ## #
## #    ##       #    #  # #   #  # #  #   #   #        #  #    # #      #    #   #    #      #    #
#                # #   #      # #  #          #        #   # #      #   ##        #  #   #       # #
##  #    # ##  ##  #              # #  #   #     #     #      #            #          ##  ## ##    #
#  #          ###    A           #             ##   # ##    #   ##     #          ###   #       ## #
###        # # # #   #  #   #    #    ##      #      #   #     #   ### ##  #   #    #   # #    #   #
#   # ####      #      ###       ##   # #     #   #   # #    # #   #   #  #     ##   ## #      ##  #
##     #    #         ## # ##     ###  ##    #      #    #              ##  #   #              # # #
# #  #      #   # #               ##      #      ##   #    # # #    ##     #    #    #        #    #
# #         #            ##  # #    # ###              #      #    #  #    #     # ####    ##     ##
##   # #  #  #    #     #       ##       # #        #  #   #    #  #       #    #  #               #
# #   ###       #  ####   ##  #   ###    #    #      #   #  ## # #           ##   #   # #### # ## ##
# ##   #            # #                 #     #####  # ## #     #     # ##             ##          #
#  #    # ##      #   #       ###    #     #         ##     ###    #      #    #     #  #  # #     #
##   #      #      #####     #  #  #       #     # ##    #    # #  #   #    #     #   #      #   ###
#     #        #  # # #        #   #        # ##   #       #   ##    #   #     # # # #         #   #
#    #      #      # ##    #  #   #         ####   #      # # # ##         #     #   ##    #       #
##   #    # #  #    ## #  ####      # #       #   # #        # ##   ### #      #      ###  #   #   #
## ##    ##     #  #   ##      #  #         #   ##      # #  ##  ##         #       #        #  ####
##      #          #  ###    ##  #      #  # ##            #    #    ## # ## # ## #         # #    #
#           ##  #    #  #  #      #  # # #  #  ##   # # ###    #     #       ##    #     #         #
#                    #          #     #     #       #  ## #  #    # # # # # #          # #   ###   #
#   #  #         #      ###    #  #  #  ##     #    # #     #          # #  ##      ###  #  ##  #  #
#  # #       #      #  ##         #  # ## #   ###    # #            # #   #        ### #           #
#      #  # #   #  #   #      #   ##   ##       #   #  #     #             #       # #   ### # ##  #
#     ##                #   # # # #  ######  ##   # #  #    # ##  #  # ##          # #       # #  ##
#   #   #       #       #  #    #      ###         ###  #     ##   #    #           # ## #      #  #
#  #   ### # #   # ### # #         # #           #          ##  #  #       #   # #    #  #   # #   #
#   #    ##   ##   #   ##    #  # ###       ##     #  ###   #    ### #             # # #  # # ##  ##
#      #  # #     ##    ##      ##  #            # ##  #  ## #         #    # # #   #     #  #   ###
#     #              #    ###         # # ##  ## #              #    ##     #   #    #       # ##  #
#   # # # ##      ##         #    ##           # #                  #         #  #       #   ##    #
# # # #     #         #   ## ##    #   #          # #    # ###     ####             # # ## ##   #  #
## #     #          # # ##  #     #  #       # #    #  #      #       # #       #      #     ##    #
# ###           #       #        #   #  #     #       #       #         ## ##      ##     #     #  #
#       ##      ## #    #  #        ##  #      # #         #     #  ##        #      ##  # #       #
##  ##   #      ##         #  #   #       ##             #          ## #   #  #       #  #  ##  #  #
#     #      #   #       ##      ##  #      ##   #   # #  ##   ##        # ##                ## #  #
#    #    # #      # #   #    #    ##       #                   ##  ##    #  # #    # #   #   #  # #
## # ##   #       #  #  #  #      ##        #    # #   # # #  #  #              ##        ## ##   ##
#  #  ## # #      # #    ###    ##    #         ###  #  #  # # ##       #           # #    # #   # #
##    #      ## #        #    #  # ###      #       #     ##    ##      #  # # #           # #    ##
# ##      # #      # ##  # #    ##  #  #    #  #          #     #  # ##     ##   #    #       # # ##
#       #      #    # # ## ###    ##       #           #  #      ###  # # # ###    #  #        # # #
#   #   #    #           #    #  # #  #      #    #  # ##        #     ## #       #  #  ##   ## #  #
# ## #  #  #  #          ##  ## #  #  ##   #             #           #  # ##                #   ## #
#     ##       ##    ####         #          #  ##                        #  ##   # #   #    # ##  #
#   #      ## ### #        #          #         #       #     ##  ##                 ##  #   #     #
#  # # #    # # #   # ##         ##    #     #  #       # #  #      #       #  #     ## #          #
#  # ##   ##    #    ## # #         ##      ##           #  ##        #               ##    #      #
#     #  ##     #  #      #   #     # #     ##   #   #  #    ## #  ##  #    #       #  #         # #
#    #  #    #    #       #        #     #                  #    #  #   #      ## ## # ##          #
# # #  ##  # #     #        # #  #     # # #     #         #      #    #    # ##    #     #        #
###    # #     #           #              #     ##        ##       #   ## #    #     #         #   #
#  #    #   #  ##   #      #  #                 #  #        #  ## #   #      #  #     #### # # ### #
# #   #    ##    #  #   #  ##  #        ### # #         #     #    #        #    #   #     #  # #  #
#        #     #      #         ###   #               #   ##     #                  #     #      # #
#                  # #  #      #    #  #   # #   ##    # # #     #  # ###          ##   #    ##    #
###  ## ##   # ##  #      # ## ###   # #            # #      ###   # # #    #          #    # ###  #
#   ###  # #        #  ##  #  #    #                 #    # #   #      ## # # #               #    #
#        #  #          #   #       # # #  #      #  ###       ## #       #  #      ##  #      ##  ##
####      #  #  #   #    #                  #        # #   ##           ####     #          #     ##
# #    # #     #      #       #    #  ####   #     #  #         #   #     # #    # #  ##        # ##
#         ###   # ##  #        ## ##      #        ###        #   # # # #    #  # ##     ## #  #   #
## #   #    #        # # # #    ## #   ## #   #   #     ###  #  ##  #    #  ####     #  #  #    #  #
#  #  # # #  #    # # # #   #           #             ###     #          ###     ##  # #   #     # #
#         # #  # ##    ##   #   #            #     #  #  # #         ####      # #  ##    ##   #  ##
##       #  ##    # ##  #  ##     # #         #       #  #        ### #          ##    #   #  B #  #
# #  #  #                  #  ## #  #    ##                #           #  ##  ##  #    #         # #
#      #    #   # ##        #       # #   # #   #        #    #  ##  #              #  #  #  #  #  #
#   # #  ## ### #        # #  #  #    #         #      ###     #  #             ##  # #   #   ## # #
#   ##       ##   ## #     #    # ## # ##                 ## #  ## #    ###  # ###    ##  #      # #
#     ###   #    # ##    #### ##        ##    #       #            #            #   #  #   #     # #
#  #  #         #   ### #   #   # #      # #  #  # #     ##    # #    ##       #  #    #     #     #
#  ##    #  #                # #  # # ## #  #     #    # #  #    ## ##      ###  #   #  ####    #  #
######     #          #          ###    #  ##       # #   #  # # # #     ##            # ##   ##   #
#   ###   #  ##   ##     #        #        # ##       #  # ##    ##  #    ###    #  #  #          ##
#         ##  #   ## # #   #    ##     ##  #            ##     #    #    # ##         ###     ## # #
#     #          #   # ### #   #  #   #      #    # #  ###  # ##   #      # # #              #     #
#           # #    #  #   #  #  #      #    #   #   ##    # #   #   # #      #      ### ##      # ##
#          #         #  # #  # #      ##  # #        #  # ##  # ##   ##                            #
#   #         #  # # # # ##    ##  #              #  #      # #   # #   #  #     ## #       #     ##
# #     # # #     #    #      ## ## #  ##    #  #  ## # #                     #    #  #  # ##    ###
#    #  #  #   # # #     ## #               ##       ##     #  # #  # ##  #   #     #      #    #  #
# #    #       #  #     ####     #  #       #    #   # #   #      #     # #   #           #       ##
####################################################################################################
