##################################################
#     # ####       #    #    #  #    #   #  ## # #
#        #  # # #    #   #    #     ###   ##   # #
# #  # #    ##  #  ### # #    # #  ## ## #       #
# #  ##  #### #    #     ##   #   # #  # ##    # #
#  #    #  # ## #           # # ## #    ##    ## #
## ##           # ##   ##  #   #### #  #   #     #
# #       #  #   #   ##      #     #   ## # #  # #
#     #  #     # #  #    ##  #   #### # ##  ##   #
# #   #    #    #   # # ##   # # #####   #   ## ##
#  ##         ##       #   #   #  # #    #   # ###
#     #  #        # # ##  # #     ## # #   ###   #
###   #    # #          # #  # #     #  #   #    #
## #####     #B    ## ##     ##   ### # # #     ##
#    #   #####   #      #   # ##          ##  ####
#   #      ###    # #  #    #  # #####  # # #   ##
#   ####      ## #####     #    # #       # #   ##
#  # #    ## #     #  ####       ### #  ## ####  #
# #   #  #      # ### # #      ###   #   ## #   ##
###     #   # #   ##  ## #  # #  ## ##     ### # #
##      #   ## #  #   # ##      #  ### ##    ##  #
#    #            # #     # #   #     # ##   ## ##
#     ## # ###   #  ###  ### # #  #  # ### ##    #
# #         #     #  #         ## #  #      #    #
#    # #  ##   ##   #    ##   ##    # # #        #
#   # ## #     ##       ##      ####   ###   ## ##
##  ##  ##  ##    # #  ####  ###  ###   ##    #  #
##      #    # # #  #   #  ###   #      #  #     #
#  # #  ##   #       ##     #  #  #       #  # # #
#  ### #  #  # # ###       #   ##         #   ## #
#        #          #    # ## #    ##      #   # #
# # ##     ##      ## #        # #   ##  ## #    #
#   #  #   #   ##    # #   #  #   #  #    ##  #  #
##     ##  #  # # #     #            ##   # #   ##
#### ##   ### ###     ####   #  #         ##  ## #
#  # ##   #   # #  #     ## # #   # #  #  #  ### #
# # # #   #   ##     #   #  ##     #     ## #    #
###      ########  #  #     # ## #  ## ###      ##
##  # #  #  ##  #     #    ##  ##   #        ##  #
# #   #   ###      #   #       #  #     #    #   #
#  #    #  #  #### ##     #      #        # # #  #
#   ##   # # ##  #  # ##   #  # #   #    ###     #
##  ## #   ## A ##      ##   #    # ###   #   #  #
# #   ##      #   ## ##    #   #     # #   #     #
#       # #       ##  ##  # # ## #     #    #  ###
#  #   ## # # #     #  ##  ##       ##    #    # #
#     #            ##  # # #  # #  ##       # ## #
#  #  #  ##   ##    ##   #   # #   #         ##  #
# #   #   # #  #  # #    # #  # ##  #  #   #     #
##################################################
